########################################
#                                      #
#                                      #
#    ###                        ###    #
#    ###                        ###    #
#                                      #
#           ################           #
#           #              #           #
#           #              #           #
#           #              #           #
#           #      ##      #           #
#                  ##                  #
#                  ##                  #
#                  ##                  #
#                  ##                  #
#    ###                        ###    #
#    ###                        ###    #
#                                      #
#                                      #
########################################